XXXXXXXXXXXXXXXXX
-----#-----------
-----------------
------*----------
--#-------#------
-----------------
-------#------&--
XXXXXXXXXXXXXXXXX
XXXXXXXXXXXXXXXXX
XXXXXXXXXXXXXXXXX
XXXXXXXXXXXXXXXXX
&
XXXXXXXXXXXXXXXXX
XXXXXXXXXXXXXXXXX
XXXXXXXXXXXXXXXXX
XXXXXXXXXXXXXXXXX
-----------------
-----------------
-----#--------&--
----------#------
-------*---------
-----#-------#---
-----------------