----------
----------
----------
----------
----------
-*&*&*&*--
----------
----------
----------
----------
----------
&
----------
----------
----------
----*-----
----&-----
----*-----
----&-----
----*-----
----&-----
----*-----
----------