----------
----------
----------
--******--
--**&&**--
--**&&**--
--******--
----------
----------
----------
----------
&
----------
----------
----------
----------
-******---
-**&&**---
-**&&**---
-******---
----------
----------
----------