^-----^-----^--^
----^-----^-----
--^-----^---*-^-
^-----^-#---^---
-&--^-----^----&
--^-----^-----^-
^-----^-----^---
----^-----^-----
--^-----^-----^-
^-----^-----^---
----^-----^----^
&
^-----^-----^--^
----^-----^-----
--^-----^-----^-
^-----^-----^---
----^-----^----&
--^-----^-----^-
^-----^-----^---
-&--^---#-^-----
--^-----^-*---^-
^-----^-----^---
----^-----^----^