--XX----------XXX
--XX----------XXX
--XX---XX-----XXX
--XX---XXXX---XXX
--XX-----XX---&--
--XXXX---XX------
--XXXX---XX------
--XXXX--#XX---XXX
--XXXX---XX---XXX
--&------XX---XXX
---------XX---XXX
&
--XX----------XXX
--XX----------XXX
--XX---XX-----XXX
--XX-#-XXXX-&-XXX
--XX-----XX------
--XXXX---XX------
--XXXX---XX------
--XXXX---XX---XXX
--XXXX---XX---XXX
-----&---XX---XXX
---------XX---XXX