XXXXXXXXXXXXXXXXX
XXXXXXXXXXXXXXXXX
-----------------
-----------------
------XXX--------
------X#*--------
------XXX-----&--
-----------------
-----------------
XXXXXXXXXXXXXXXXX
XXXXXXXXXXXXXXXXX
&
XXXXXXXXXXXXXXXXX
XXXXXXXXXXXXXXXXX
-----------------
-----------------
------XXX--------
------*#X--------
------XXX-----&--
-----------------
-----------------
XXXXXXXXXXXXXXXXX
XXXXXXXXXXXXXXXXX