----------
----------
--^^------
--^^----X-
--^^----X-
-&^^-XXXX-
--^^-#*-X-
--^^----X-
--^^------
-------#--
----------
&
----------
----------
--^^------
--^^------
--^^------
-&^^-XXXX-
--^^-#*-X-
--^^----X-
--^^------
--------#-
----------