XXXXXXXXXXXXXXX
XXXXXXXXXXXXXXX
---------------
---------------
-------*-------
-------#-------
---------------
---------------
---------------
XXXXXXXXXXXXXXX
XXXXXXXXXXXXXXX
&
XXXXXXXXXXXXXXX
XXXXXXXXXXXXXXX
-------*-------
---------------
-------#-------
---------------
---------------
---------------
---------------
XXXXXXXXXXXXXXX
XXXXXXXXXXXXXXX
&
XXXXXXXXXXXXXXX
XXXXXXXXXXXXXXX
---------------
---------------
---------------
---------------
-------#-----*-
---------------
---------------
XXXXXXXXXXXXXXX
XXXXXXXXXXXXXXX