-XXXXXXXXXXXXX-
-XXXXXXXXXXXXX-
---------------
---------------
-------*-------
-------#-------
---------------
---------------
---------------
-XXXXXXXXXXXXX-
-XXXXXXXXXXXXX-
&
-XXXXXXXXXXXXX-
-XXXXXXXXXXXXX-
-------*-------
---------------
-------#-------
---------------
---------------
---------------
---------------
-XXXXXXXXXXXXX-
-XXXXXXXXXXXXX-
&
-XXXXXXXXXXXXX-
-XXXXXXXXXXXXX-
---------------
---------------
---------------
---------------
-------#-------
---------------
-------*-------
-XXXXXXXXXXXXX-
-XXXXXXXXXXXXX-