------------X---
---X-------XXX--
--XXX---X---X---
---X---XXX-----&
--------X---X---
------#----XXX--
---X--------X---
--XXX---X-----#-
---X---XXX--X---
--------X--XXX--
------------X---
&
------------X---
---X--#----XXX--
--XXX---X---X---
---X---XXX-----&
--------X---X---
-----------XXX--
---X--------X---
--XXX---X-------
---X---XXX--X---
-----#--X--XXX--
------------X---