^-----^-#---^--^
----^-----^-----
--^-----^---*-^-
^-----^-#---^---
-&--^-----^---#-
--^-----^-----^-
^-----^-----^--&
----^-----^-----
--^-----^-----^-
^-----^-----^---
----^-----^----^
&
^-----^-----^--^
----^-----^-----
--^-----^-----^-
^-----^-----^---
----^-----^----&
--^-----^-----^-
^-----^-----^---
-&--^---#-^---#-
--^-----^-*---^-
^-----^-----^---
----^---#-^----^