^--#--^-#---^--^
----^-----^-----
--^-----^---*-^-
^-----^-#---^---
-&--^-----^---#-
--^-----^-----^-
^--#--^-----^--&
----^--#--^-----
--^-----^-----^-
^--#--^-----^---
----^-----^----^
&
^-----^-----^--^
----^--#--^-----
--^-----^-#---^-
^#----^-----^---
----^--#--^----&
--^-----^-----^-
^-----^-----^---
-&--^---#-^---#-
--^-----^-*---^-
^-----^-----^---
----^---#-^----^