^-----^-#---^--^
----^-----^-----
--^-----^---*-^-
^-----^-#---^--&
-&--^-----^-----
--^-----^-----^-
^-----^-----^---
----^-----^-----
--^-----^-----^-
^-----^-----^---
----^-----^----^
&
^-----^-----^--^
----^-----^-----
--^-----^-----^-
^-----^-----^---
----^-----^-----
--^-----^-----^-
^-----^-----^---
-&--^---#-^----&
--^-----^-*---^-
^-----^-----^---
----^---#-^----^