---------------XX
-------&-------XX
--XXXXXXXXX----XX
--XXXXXXXXX----XX
--XX-----------XX
--XX-----------XX
--XX----XXXXXXXXX
--XX----XXXXXXXXX
--XX--------&----
--XX-------------
--XXXXXXXXXXXXXXX
&
---------------XX
----&----------XX
--XXXXXXXXX----XX
--XXXXXXXXX----XX
--XX-----------XX
--XX-----------XX
--XX----XXXXXXXXX
--XX----XXXXXXXXX
--XX-----&-------
--XX-------------
--XXXXXXXXXXXXXXX