-----------------
-----------------
-----------------
-----------------
------XXX--------
------X#*---#-----
------XXX-----&--
-----------------
-----------------
-----------------
-----------------
&
-----------------
-----------------
-----------------
-----------------
------XXX--------
--#---*#X--------
------XXX-----&--
-----------------
-----------------
-----------------
-----------------