----------
----------
----------
--------X-
--------X-
-----XXXX-
-----#*-X-
--------X-
----------
-------#--
----------
&
----------
----------
----------
----------
----------
-----XXXX-
-----#*-X-
--------X-
----------
--------#-
----------
&
----------
----XXXXX-
----#*--X-
--------X-
----------
----------
--------#-
----------
----------
----------
----------