@XXXXXXXX
-XXXXXXXX
-XXXXXXXX
-XXXXXXXX
-XXXXXXXX
-XXXXXXXX
-----#---
--------O