----------------XXXXX
---------------------
*-----------------#*-
--------X---^--------
--------X--*---------
---XXXXXX------------
----*#*-X-&-^--------
--------X------------
*-----------------#*-
-------#-------------
-------------*--XXXXX
