------XXXXXX-XXXXXXXXXXXX
#-----XXXXXX----------XXX
------XXXXXX---#*--#--XXX
---X--XXXXXX----------XXX
*--X---------------------
XXXX---------------------
*--X----#---&-----------*
---X------------------XXX
----------*----#*--#--XXX
#-------#-------------XXX
-------------XXXXXXXXXXXX