-------X-----XX----^^^--------
-------X-----XX---------------
--*X---X-----XX-----&----XX---
--#X-&-X---&-XX----^^^---XX---
---X---X-----------^^^---XX---
---X---X--------#--^^^---XX---
---X---X-----------^^^---XX---
---X---X-----XX----^^^---XX---
---X---X-----XX----^^^---XX---
---X---------XX----^^^---XX---
---X---------XX----^^^---XX---